am I your best friend: leolani-best-friend be lenka
are you a girl: leolani be girl
are you afraid of dogs: leolani be afraid-of-dogs
are your from the netherlands: leolani be-from the-netherlands
am I from the netherlands: lenka be-from the-netherlands
are your parents from the netherlands: leolani-parents be-from the-netherlands
can I call you: Lenka call Leolani: call
can I make a cake: Lenka make cake: can
can a bird sing a song: a-bird sing song: can
can my friend talk to you: lenka-friend talk-to leolani: can
can you recommend a book about history: leolani recommend book-about-history: can
can you sing: leolani sing ?: can
can you talk to me: leolani talk-to lenka: can
can you tell me what is a dog: a-dog be ?: can
can't you come to university: leolani come-to university: can
could you hear me: leolani hear lenka: could
did lana read a book: lana read book
did you ever go to Paris: leolani go-to paris
did you go to school yesterday: leolani go-to school-yesterday
did you meet a pretty girl: leolani meet pretty-girl
did you meet john: leolani meet john
did you see a dog: leolani see dog
did you sing a song about rain: leolani sing song-about-rain
did you talk with Selene: leolani talk-with selene
didn't you see Selene: leolani see selene
do you know a dangerous animal: leolani know dangerous-animal
do you know me: leolani know lenka
do you know what a dog is: dog be ?
do you like amsterdam: leolani like amsterdam
do you like living in amsterdam: leolani like living-in-amsterdam
do you like new york: leolani like new-york
do you like to live in new york: leolani like to-live-in-new-york
do you like talking to people: leolani like talking-to-people
do you see a dog: leolani see dog
does john enjoy watching movies: john enjoy watching-movies
does john live in the building: john live-in the-building
does selene know suzana: selene know suzana
does your sister know me: leolani-sister know lenka
have you ever been to Paris: leolani be-to paris
have you ever seen a dog: leolani see a-dog
haven't you been in New York: leolani be-in new-york
is purple your favorite color: leolani-favorite-color be purple
is your best friend Selene: leolani-best-friend be selene
is your favorite food pizza: leolani-favorite-food be pizza
is your friend called susie: leolani-friend call susie
must you go home: Leolani go home: must
will you come tomorrow: leolani come tomorrow: will
will you go to Paris: leolani go-to paris: will
