I am a person: lenka be person
I am a person: lenka be person
I am from serbia: lenka be-from serbia
I come from the Netherlands: lenka be-from the-netherlands
I don't enjoy washing the dishes: lenka enjoy washing-the-dishes: not
I don't think selene likes cheese: selene like cheese: think not
I have always liked reading comic books: lenka like reading-comic-books
I have heard about you: lenka hear-about leolani
I have never been to Japan: lenka be-to japan: not
I have three white cats: lenka have three-white-cats
I have to go home: lenka go-to home: must
I know selene might come today: selene come today: might know
I know that you like me: leolani like lenka: know
I know you: lenka know leolani
I like to smell flowers: lenka like to-smell-flowers
I like to talk: lenka like to-talk
I live in New York: lenka live-in new-york
I live in the Netherlands: lenka live-in the-netherlands
I live in the Netherlands: lenka live-in the-netherlands
I love ice-cream: lenka love ice-cream
I love looking at the starry sky: lenka love looking-at-the-starry-sky
I must go home: lenka go home: must
I must go to Paris: lenka go-to Paris: must
I own three beautiful cats: lenka own three-beautiful-cats
I think Selene doesn't like cheese: selene like cheese: think not
I think Selene hates cheese: selene hate cheese: think
I want to go home: lenka go home: want
I was born in the U.K. : lenka born-in the-u.k.
I wouldn't like to eat pizza: lenka like to-eat-pizza: would not
animals must drink water: animals drink water: must
animals must eat food: animals eat food: must
birds cannot talk: birds talk: can not
bram hates being late: bram hate being-late
bram likes hockey: bram like hockey
bram loves sport: bram love sport
cat is a pet: cat be pet
food should be healthy: food be healthy: should
houses should be warm: houses be warm: should
humans can drink beer: humans drink beer: can
humans can eat food: humans eat food: can
john enjoys watching movies: john enjoy watching-movies
john likes to watch movies: john like to-watch-movies
john will come to Amsterdam: john come-to Amsterdam: will
lana can read a book: lana read book: can
lana can ride a bike: lana ride bike: can
lana is reading a book: lana read book
lana is writing a book: lana write book: now
lana must eat: lana eat something: must
lana must read: lana read something: must
lana read a book: lana read book
lana write a book: lana write book
leolani is a robot: leolani be robot
leolani likes helping people: leolani like helping-people
leolani you are my best friend: lenka best-friend leolani
my best friend is john: lenka best-friend john
my father's favorite movie is the Titanic: lenka-father favorite-movie the-titanic
my mother loves the beatles: lenka-mother love the-beatles
my sister doesn't like baking cakes: lenka-sister like baking-cakes: not
my sister's name is Emma: lenka-sister name emma
reading is an activity: reading be activity
selene is from mexico: selene be-from mexico
selene likes baking cakes: selene like baking-cakes
selene loves to bake cakes: Selene love to-bake-cakes
selene might come today: selene come today: might
sorry this is my chair: lenka own chair
suzana might have been at home: suzana be-at home: might
swimming is a sport: swimming be sport
that is a lovely shirt: shirt be lovely
that is my cup: lenka own cup
these books are mine: lenka own these-books
they are not going to the university: they go-to the-university: not
this is a pink chair: this be pink-chair
this is a teddy-bear: this be teddy-bear
this is my favorite song: lenka favorite-song this
this yellow fruit is a banana: this-yellow-fruit be banana
you are a robot: leolani be robot
you are going to england: leolani go-to england: future
you come from france: leolani be-from france
you have been in paris: leolani be-in paris: have-been
you like talking to people: leolani like talking-to-people
you live in amsterdam: leolani live-in amsterdam
you live in this office: leolani live-in this-office
you may come from france: leolani be-from france: may
you should go: leolani go somewhere: should
you think my name is anna: lenka name anna: think
you were in paris: leolani be-in paris: past
you will go to england: leolani go-to england: future
your sister must come to Amsterdam: leolani-sister come-to amsterdam: must
